
Modulo06 

Anotações de aula:

at first = no começo / inicialmente


He's going to / He is going to = ele vai 
I'm going to 
You're going to 
 


You should go... = você deveria ir 


stuff  = varias coisas ( meio abstratos )
things = varias coisas


take someone's advice = aceitar o conselho 


get in shape = entrar em forma 

all of a sudden = de repente

belittiling = menosprezar / diminuir 

because what happens now = porque o que acontece agora 


shine = brilhar 
shining down = iluminando ( de cima para baixo ) 

endeavor = esforço 
current = atual  

reminfd = lembrar 


they could have = eles poderiam ter


came up short = morrer na praia/ não chegar lá / ficar a aquém 


they didn't revisit it = eles não revisitaram isso 


go = ir 
went = foi 
they went at it = eles tetantam fazer isso


fail = falhar/fracassar
failure = o fracasso 


stand = ficar
stood = ficou/ restou 


every single time = todas as vezes ( com ênfase) 

it goes his way = isso vai no caminho dele / vai na direção dele


