Módulo 07 - Success | Part 03



post office = correio 


down = para baixo 

you're down thath path = você está neste caminho 

all alone = completamente sozinho 

How do you know = como você sabe 
How do you do them = "como você faz elas"


what you're doing is in the right Direction = que você está na direção certa


if you're wondering = Se você está pensando/ refletindo 

wondering = refletindo
thinking = pensando


look at = olhar para 
look for = procurar 

washing your car = lavando seu carro


Say = digamos que 
spend = gastar

you finish washing it 
you put ... away = você guarda 

the hose = as mangueiras 
the brusches = as escovas 


you come back outside = você volta para fora(rua)

to look at = olhar para 

you notice = notar / perceber / reparar

spot =local / ponto 

miss = errar o alvo / falta 

what do you do = o que você faz


grab = pegar / agarrar 


pull = puxar 

properly = corretamente / propriamente 
proper = correto / apropriado 

you know = sabe 


that's good enough = bom suficiente / já está bom 

Until = até 

nth = enésima

on the line = tudo está em jogo / na linha 

That's when = é nessa hora 

come up short = "morrer na praia"


suck = sugar /  - that suck -informalmente pode ser " é muito ruim"/"é droga"

that makes you = que faz/define você

right there = uma expressão "exatamente nesse ponto"










